((339))

Fachliches Englisch

((340))

Business terms

account book - Kontobuch 
admonition - Mahnung 
bank surety - Bankbürgschaft 
bonus - Prämie 
business friend - Geschäftsfreund 
cash payment - Barzahlung 
catalog(ue) - Katalog 
charge - Gebühr 
charge - Belastung des Kontos 
cheque - Scheck 
commercial conditions - Kommerzielle Bedingungen
commission - Provision 
complaint - Reklamation 
conditions of payment - Zahlungsbedingungen 
confirmation - Bestätigung 
contract - Vertrag 
contractor - Lieferant 
contractor account - Lieferantenkonto 
contractual penalty - Vertragsstrafe 
cost - Kosten 
credit - Haben 
credit - Kredit 
credit giver - Kreditgeber 
credit voucher - Gutschrift 
customer account - Kundenkonto 
customs declaration	Zollerklärung 
damage in transit - Transportschaden 
date - Termin 
debit - Soll 
debit entry - Lastschrift 
default interest - Verzugszins 
delay - Verzögerung 
delayed delivery - Lieferungsverzug 
delivered possibility - Liefermöglichkeit 
delivery note - Lieferschein 
delivery deadline - Liefertermin 
destination port - Zielhafen 
development - Entwicklung 
directions for use - Gebrauchsanweisung 
discount - Rabatt 
discount-cash - Skonto 
dispatch - Versand 
dispatch conditions - Versandbedingungen
duty - Zoll 
earning - Verdienst; Gehalt 
end customer - Endkunde 
european currency (ECU) - Europäische Währungseinheit (ECU) 
export regulation - Ausfuhrvorschriften 
faulty  consignment - Fehlerhafte Sendung 
forwarding agent - Spediteur 
free border - Freie Grenze 
free samplev - Kostenloses Muster 
government - Regierung 
guarantee - Garantie 
manuals - Handbücher 
imporl - Import 
incomplete delivery - Unvollständige Lieferung
inquiry - Anfrage 
installation for use - Installationsanweisung
interest - Zins
international money order - Internationale Zahlungsanweisung
international standard - Internationale
book number (ISBN) - Standardbuchnummer
public limited company — (PLC)/(stock) corporation
(amerikanisch) - Aktiengesellschaft (AG) 
legal domicile - Gerichtsstand
legal lawyer - Rechtsanwalt 
legal position - Rechtslage
length of guarantee - Garantiezeit 
license - Lizenz
 list of material - Materialliste 
manufacturer - Hersteller
marketing - Marketing 
negotiation - Verhandlung 
offer - Angebot 
order - Auftrag; Bestellung
order to pay - Zahlungsanweisung
order to volume - Bestellumfang 
packing material - Verpackungsmaterial
(general) partnership - Offene Handels¬gesellschaft (OHG)
payment - Bezahlung
personal identification - Persönliche
number (PIN) - ldentifikationsnummer
piece - Stück
price - Preis
private limited company - GmbH
product - Produkt
profit/loss - Gewinn/Verlust
project - Projekt
prototype - Prototyp
purchase an credit - Kreditkauf
quality - Qualität
quantity delivered - Lieferumfang
quantitys - Mengen
receipt - Quittung
record - Beleg
reduction - Nachlass
replacement part - Ersatzteile
sales invoice - Rechnung
samples supplied - Mustersendung
set - Satz
settlement - Abrechnung
settlement process - Abrechnungsverfahren
shareholder - Aktionär
statement - Abrechnungsbeleg
storage charge - Lagerkosten
storeroom - Lagerraum
supply contract - Lieferungsvertrag
terms of delivery - Lieferungsbedingungen
transfer - Überweisung
transport company - Transportfirma
value added tax - Mehrwertsteuer
wages per hour - Stundenlohn
warehouse - Lager
working group; syndicate – Arbeitsgemeinschaft

Professions/Departments/Post/Transport

Names of professions
accountant – Buchhalter 
administration – Verwaltung 
agent – Vertreter
ambassador – Botschafter
area manager – Bezirksleiter 
auditor – Wirtschaftsprüfer 
branch manager – Filialleiter 
broker – Makler
buyer – Einkäufer
chairman – Präsident, Vorsitzender
chairwoman – Präsidentin. Vorsitzende
chief engineer – leitender Ingenieur 
chief executive (CEO) – Hauptgeschäftsführer
chief financial officer – Leiter der Finanzabteilung (CFO)
commercial representative – Handelsvertreter
company secretary – Verwaltungsdirektor
consultant – Berater 
copywriter – Werbetexter
customer service – Kundendienstleiter manager
deputy – Stellvertretender Assistent
design engineer – Konstrukteur 
development engineer – Entwicklungsingenieur
general manager – Generaldirektor
director of public – Direktor der Abteilung für
relations – Öffentlichkeitsarbeit
editor in chief – Chefredakteur 
engineering manager – Leiter der technischen Abteilung
factory manager – Werksleiter 
field sales manager – Außendienstleiter 
general executive – Generaldirektor einer AG manager (GM)
head – Chef; Direktor; Leiter 
head of staff – Leiter der Personalabteilung
import manager – Leiter der Importabteilung
lecturer – Dozent; Lektor 
logistics manager – Leiter der Logistikabteilung 
managing director (MD) – Geschäftsführendes Vorstandsmitglied marketing assistant – Assistent der Marketingabteilung
owner – Inhaber 
partner – Gesellschafter; Teilhaber
planning director – Leiter der Planungsabteilung
press officer – Pressesprecher
programmer – Programmierer
project leader – Projektleiter 
publicity manager – Werbeleiter 
purchasing manager – Einkaufsleiter
research director – Leiter der Forschungsabteilung
sales representative – Handelsvertreter
salesman – Verkäufer 
senior manager – Leitender Mitarbeiter
special assistant to managing director – Sekretär der Geschäflsleitung
systems manager – Leiter der EDV-Abteilung
vice chairman – Stellvertretender Generaldirektor

Departments of a company
Accounts Department – Buchhaltung 
Administration	Verwaltung – Department
Advertising Department – Werbeabteilung 
Commercial Department – Handelsabteilung 
Finance Department – Finanzabteilung
Human Resources Department – Personalabteilung 
Legal Department – Rechtsabteilung
Marketing Department – Marketingabteilung 
Public Relations Department – Abteilung für Öffentlichkeitsarbeit
	
Purchasing Department – Einkaufsabteilung 
Research and Development – Forschung und Entwicklung
Sales Department – Verkaufsabteilung 
Technical Department – Technische Abteilung
Training Department – Schulungsabteilung
##eingelesen bis hier
Postal and transport terms
(fully insured) registered letter – Wertbrief 
Addresses – Empfänger 
By airmail – Per Luftpost 
By courier – Per Kurier
Cash an delivery (COD) – Nachnahme 
Confidential – Vertraulich 
Do not fold – Bitte nicht knicken
Excess to pay – Nachgebühr 
Express delivery – Eilzustellung
Express letter – Eilbrief 
If undelivered, please return to (sender)– Falls unzustellbar, bitte zurück an Absender
Not known at this address – Empfänger unbekannt 
Please forward – Bitte nachsenden
Postage Paid – Portofrei
Poste Restante – Postlagernd 
Printed matter – Drucksache 
Private and confidential – Streng vertraulich 
Private; Personal – Persönlich 
Registered letter – Einschreiben
Registered letter with – Einschreiben gegen
confirmation of delivery – Rückschein
Return postage – Rückporto
Sample of no commercial value – Muster ohne Wert 
Sender; From – Absender 
Special issue stamp – Sondermarke
Urgent – Dringend 
Weight – Gewicht
a. c. mater - Wechselstromzähler
absorbed power - Aufgenommene Leistung 
air conditioner - Klimaanlage 
alternating current - Wechselstrom 
alternating voltage - Wechselspannung 
amperage - Stromstärke in Ampere
attenuation - Abschwächung 
battery - Batterie 
battery charger - Batterieladegerät 
battery-operated - Batteriebetrieben 
boost(ing) - Verstärkung 
bridge rectifier -	Brückengleichrichter 
bridging; bypass - Überbrückung 
bus (bar) - Sammelschiene 
cable branching - Kabelabzweig 
cable capacity  - Kabelkapazität 
nable conducter - Kabelader 
cable runaway - Kabelrost 
capacitor - Kondensator 
Gase; housing; cubicle - Gehäuse 
circuit; connection - Schaltung 
coaxial line - Koaxialleitung 
coil; inductance - Spule 
conductor cross - Leiterquerschnitt 
connecting terminal - Verbindungsklemme 
connector - Steckverbinder 
container connection - Gehäuseanschluss 
current source - Stromquelle 
cylindrical winding - Zylinderwicklung 
difference in phase - Phasenverschiebung 
direct current (d. c.) - Gleichstrom 
direct voltage - Gleichspannung 
drop – off time lag - Abfallverzögerung 
earth conductor - Schutzleiter 
earth potential - Erdpotenzial 
efficiency (factor) - Wirkungsgrad 
electric power - Elektrische Leistung 
electric shock - Schlag, elektrischer 
electrode - Elektrode 
energy store - Energiespeicher 
fault current - Fehlerstrom 
fuse - Sicherung 
good earthing - Erdung 
heating - Heizung 
impedance - Scheinwiderstand 
in parallel - Parallelschaltung 
inductivity - Induktivität 
interrupting current - Abschaltstrom 
inverter - Wechselrichter 
joint (splice) box - Kabelmuffe 
junction box - Abzweigdose 
leakage resistance - Ableitwiderstand 
lightning protection - Blitzschutz 
line filterv - etzfilter 
main switch - Hauptschalter 
mains connection - Netzanschluss 
mains frequency - Netzfrequenz 
mains supply gap - Netzlücke 
measuring line - Messleitung 
net load capacity - Netzkapazität
neutral point - Nullpunkt
nominal voltage - Nennspannung
ohmic resistance - Wirkwiderstand
overload - Überlast 
overvoltage - Überspannung
overvoltage protection - Überspannungsschutz
overvoltage release - Überspannungsauslösung 
parallel Operation - Parallelbetrieb
pigtail - Drahtende 
plant - Anlage 
power (energy) transmission - Energieübertragung 
power consumption - Leistungsverbrauch 
power line - Netzleitung 
power pack - Netzteil 
power supply - Stromversorgung
power; wattage(in Watt) - Leistung 
primary voltage - Primärspannung 
protection against contact - Schutz gegen Berühren 
protection circuit - Schutzschaltung
pull-in delay time - Anzugsverzögerung 
rechargeable battery - Aufladbare Batterie 
rectifier - Gleichrichter
relay - Relais 
resistance network - Widerstandsnetzwerk
resistor - Widerstand 
ring mains; loop - Ringleitung 
rotary converter - Rotierender Umformer 
screening factor - Abschirmfaktor 
screening; shielding - Schirmung 
secondary voltage - Sekundärspannung 
series connection - Serienschaltung 
series impedance - Längsimpedanz 
short circuit - Kurzschluss 
shunt resistor - Querwiderstand 
solar current - Solarstrom 
spare withdrawable unit - Reserveeinschub 
speed variation - Drehzahländerung 
standby; back up - Reserve 
starter battery - Anlassbatterie 
stationary battery - Ortsfeste Batterie 
switch; circuit breaker - Schalter 
temperature range - Temperaturbereich 
thermal power station - Wärmekraftwerk 
timeload withstand strength - Zeitbelastungsfestigkeit 
to charge - Aufladen 
transformer - Transformator 
transformer ratio - Übersetzungsverhältnis 
transformer tap - Transformatoranzapfung _
transformer; - transmitter	Übertrager 
two wire line - Doppelleitung 
uninterruptible power supply (UPS)- Unterbrechungsfreie Stromversorgung
vacuum arrester - Vakuumableiter 
vibrating reed frequency mater - Zungenfrequenzmesser 
voltage source	- Spannungsquelle  
wind power plant - Windkraftanlage
working voltage – Betriebsspannung
